--------------------------------------------------------------------------------------------------------------------------------------------------------------------------------------------------------
--------------------------------------------------------------------------------------------------------------------------------------------------------------------------------------------------------
--------------------------------------------------------------------------------------------------------------------------------------------------------------------------------------------------------
----------------------------------------------------------------------------------------------------------------------------------------------------------------------------------?---------------------
-----------------------------------------------------------------------------------------------------------------------------------------------------------------X--------------------------------------
----------------------------------------------------------------------------------------------------------------------------------------------------------------XX--------------------------------------
---------------------------------------------------------------------------------------------------------------------------------------------------------------XXX--------------------------------------
----------------------------------------------------------------X---------------------------------------------------------------------------------------------XXXX-------------------------------------v
---------------------------------------------------------------XX--------------------------------------------------------------------------------------------XXXXX-------------------------------------f
---------XXXXX-----------------------------------------X------XXX----------XXXX----------------M------------------------------------------------------------XXXXXX-------------------------------------f
------------------------------------------------------XX-----XXXX---------------------------------------------------------------------------------------T--XXXXXXX-------------------------------------f
-----------------------------------------------------XXXT---XXXXX--------------------------------X------------------------------------------------------|-XXXXXXXX-------------------------------------f
-----------X----------------------------------------XXXX|--XXXXXX--------------------------------XX--------------------------------------------------B--|XXXXXXXXX------------------------B------------f
-----------XX-------------------------------------TXXXXX|-XXXXXXX--------------------------------XXX------------o--------------------------XXXXX--------|XXXXXXXXX-------------------------------------f
m----------XXX------------------------------------|XXXXX|XXXXXXXX--------------------------------XXXXE---------B---------------------------------------X|XXXXXXXXX-------------------------------------X
XXXXXXXXXXXXXXXXXXXXXXXXXXXXXXXXXXXXXXXXXXXXXXXX-X|XXXXX|XXXXXXXXXXXXXXXXXXXXXXXXXXXXXXXXXXXXXXXXXXXXXXXXXXXXXXXXXXXXXXXXXXXXXXXXXXXXXXXXXXXXXXXXXXXXXXX|XXXXXXXXXXXXX-XXXXXXXXXXXXXXXXXXXXXXXXXXXXXXXXX
